{
    "tiles" : [ [1, 1, 1, 1, 0, 1, 1, 1, 1 ],
                [1, 0, 1, 1, 0, 1, 1, 0, 1 ],
                [1, 0, 1, 1, 0, 1, 1, 0, 1 ],
                [1, 1, 1, 1, 1, 1, 1, 1, 1 ],
                [0, 0, 1, 1, 1, 1, 1, 0, 0 ],
                [1, 1, 1, 1, 1, 1, 1, 1, 1 ],
                [1, 1, 1, 1, 1, 1, 1, 1, 1 ],
                [1, 0, 1, 0, 1, 0, 1, 0, 1 ],
                [1, 0, 1, 0, 1, 0, 1, 0, 1 ] ],
    
    "targetScore" : 1000,
    "moves" : 10,
    "level": 10,
    "elfin": 4,

}