{
    "tiles" : [ [0, 0, 1, 1, 1, 1, 1, 1, 1 ],
                [0, 1, 1, 1, 1, 1, 1, 1, 0 ],
                [1, 1, 1, 1, 1, 1, 1, 0, 0 ],
                [1, 1, 1, 1, 1, 1, 0, 0, 0 ],
                [1, 1, 1, 1, 1, 0, 0, 0, 0 ],
                [1, 1, 1, 1, 1, 0, 0, 0, 0 ],
                [1, 1, 1, 1, 1, 1, 0, 0, 0 ],
                [0, 1, 1, 1, 1, 1, 1, 1, 0 ],
                [0, 0, 1, 1, 1, 1, 1, 1, 1 ] ],
    
    "targetScore" : 1000,
    "moves" : 10,
    "level": 6,
    "elfin": 4,

}